#######
#     #
#  *  #
#  @  #
#     #
#     #
#######