#######
#     #
#     #
#  @  #
#     #
#     #
#######